111111111111111111111111
1S00010000000000001000E1
100001000001000000100001
100001000001000000100001
100001000001000000100001
100001000001000000100001
100001000001000000100001
100001000001000000100001
100001000001000000100001
100001000001000000100001
100000000001000000000001
111111111111111111111111
