111111111111111111111111
1S0000000000000000000001
100001000001000000100001
100001000001000000100001
100001000001000000100001
100001000001000000100001
100001000001000000100001
100001000001000000100001
100001000001000000100001
100001000001000000100001
1000010000010000001000E1
111111111111111111111111
