11111
1S001
10101
100E1
11111
