11111111
1S001001
10000001
10001001
10001001
100000E1
11111111
