1111111111111111111
1S00000000000000001
1100000001000000001
1000000001000000001
10000000000001E1001
1000000001000010001
1000000001000000001
1000000001000000001
1111111111111111111
