11111
1S001
10001
100E1
11111
